verse=n.韵文,诗;诗节,诗句
outrage=n.暴行,侮辱,愤怒 v.凌辱,引起…义愤,强奸
petition=n.请愿书,申请书 v.(向…)请愿,正式请求
thrill=n.一阵激动(恐惧) v.激动；(使)毛骨悚然
cope=v.(with)竞争,对抗;(with)对付,妥善处理
hostile=a.敌对的,敌方的,敌意的
steamer=n.汽船,轮船
novel=n.(长篇)小说 a.新奇的,新颖的
lapse=n.失误,流逝,丧失,下降 v.失效,偏离,流逝
vanish=vi.突然不见;消失
lung=n.肺
challenge=n.挑战(书);艰巨任务,难题 v.向…挑战
missionary=a.教会的，传教(士)的 n.传教士
scholar=n.学者
spear=n.矛,枪
plausible=a.似是而非的,似乎合理的,似乎可信的
deprive=vt.剥夺,夺去,使丧失
fridge=n.(refrigerator 的略语)冰箱
gesture=n.姿势,姿态,手势 v.做手势
spade=n.铁锹,铲子
leather=n.皮革,皮革制品
repel=v.击退,抵制,使厌恶,使不愉快
plentiful=a.富裕的,丰富的
mutton=n.羊肉
fur=n.毛,毛皮
laser=n.激光
toxic=a.有毒的；中毒的
guidance=n.引导,指导
timid=a.胆怯的,怯懦的
reform=v./n.改革,改造,改良
trait=n.特征,特点,特性
stiff=a.硬的,僵直的;拘谨的;呆板的;艰难的
description=n.描写,形容;种类
recipe=n.烹饪法,食谱;诀窍,方法
romance=n.传奇,爱情故事
segment=n.段,片,节,部分
series=n.一系列,连续;丛书
signature=n.签名,署名,签字
victim=n.牺牲品,受害者
avoid=vt.防止，避免；逃避，避开
dawn=n.黎明；开端 v.破晓，开始
supersonic=a.超音速的,超声波的 n.超声波，超声频
density=n.密集,密度,浓度
drought=n.旱灾,干旱
sparkle=v.发火花,闪耀
deflate=v.放气；使泄气；减轻，减少
inhale=v.吸入(气体等)，吸(烟)
aviation=n.航空，航空学；飞机制造业
estimate=v./n.估计,估价;评估
resume=v.再继续,重新开始;再用;恢复 n.个人简历 
economy=n.节约;经济
organize=v.(organise)组织,编组
monster=n.怪物,妖怪,畸形的动植物
sow=v.播种
recognize=v.(recognise)认出,承认,公认,赏识,表扬
organ=n.器官;机构,机关;风琴
culture=n.文化；文明；培养
wax=n.蜡,蜂蜡 v.打蜡
artery=n.动脉；干线，要道
submarine=n.潜水艇 a.水底的,海底的
locality=n.位置,地点
minus=a.负的,减的 prep.减去 n.负号,减号
stream=n.小河,溪流;流,一股,一串 v.流出,涌
enable=v.使能够,使成为可能;授予权利或方法
quiver=v./n.颤抖,抖动
zoom=vi.(飞机)陡升 n.陡升；嗡嗡声
obedience=n.服从,顺从
civilian=n.平民 a.平民的;民用的
discrepancy=n.相差;差异;矛盾;
yell=vi.大叫;呼喊 vt.叫着说 n.叫声;喊声
X-ray=n.X 射线,X 光
consent=v./n.(to)同意,赞成,答应
export=v./n.输出,出口 n.出口商品
curiosity=n.好奇心，求知欲，珍品
bargain=n.廉价货;交易,契约,合同 v.议价,成交
alien=n.外侨，外国人；外星人 a.外国的；相异的
mushroom=n.蘑菇 vt.迅速生长,迅速增加,采蘑菇
fluid=a.流动的,液体的 n.流体,液体
racial=a.种的,种族的
biography=n.传记；传记文学
cry=v.哭泣，喊叫 n.叫喊，哭声
bureau=n.署,局,司,处
