答错 excerpt=n./vt.摘录;引用
没答 interview=v./n.接见,会见;采访;面试
答错 numerous=a.众多的,许多的,大批的
答错 rouse=vt./vi.唤醒，唤起；激励；激起
答错 purify=v.使纯净,提纯
没答 refrain=v.节制,避免,制止 n.(诗的)叠句
没答 bound=v./n.跳(跃) a.被束缚的，一定的；n.界限
没答 autonomy=n.自治，自治权
没答 implement=n.(pl.)工具,器具 v.贯彻,实现
没答 virgin=n.处女 a.处女的;纯洁的;原始的;未使用的
答错 pavement=n.人行道
没答 mathematical=a.数学的；数学上的
答错 napkin=n.餐巾,餐巾纸,<英>尿布
没答 withhold=vt.使停止;拒给;保留;抑制 vi.忍住
没答 exceedingly=ad.极端地,非常
没答 agency=n.代理(处)；代办处
没答 fluent=a.流利的,流畅的
没答 enrich=v.使富足;使肥沃;装饰;加料于;浓缩
没答 van=n.有篷汽车;有篷货运车厢
没答 cordial=a.诚恳的,亲切的,热诚的
没答 flap=n.垂下物,帽沿,袋盖 n./v.拍打,拍动
没答 accustomed=a.惯常的；习惯的，适应的(一般作表语)
答错 singular=a.非凡的,卓越的;单数的
没答 pad=n.垫,衬垫;便笺簿 v.加上衬垫
答错 condense=v.(使)冷凝，(使)凝结；浓缩，压缩，简缩 
答错 paperback=n.平装本，简装本
答错 numerical=a.数字的，用数字表示的，数值的
答错 resemble=v.像,类似
没答 incentive=n.刺激;动力;鼓励;诱因;动机
没答 complication=n.复杂,纠纷;并发症
没答 posture=n.姿势,姿态,心态,态度 v.作出某种姿势
没答 specify=v.指定,详细说明
没答 extend=v.延长,延伸;扩充;给予;提供;估价
没答 deficit=n.赤字，亏损；不足，缺乏
没答 statute=n.成文法，法令，法规；章程，规则，条例
答错 climate=n.气候;风气,社会思潮
没答 layman=n.外行
没答 brandy=n.白兰地酒
没答 abstract=a.抽象的 n.摘要，梗概 vt.提取；摘录要点
答错 chill=n.寒冷,寒气,寒战 v.使寒冷 
没答 sponsor=n.发起人,主力者,保证人 v.发起,主办
没答 denounce=vt.公开指责,公然抨击;谴责
答错 blush=v./n.脸红
没答 shortly=ad.立刻，不久；不耐烦地，简慢地
没答 illustration=n.说明；例证，插图；举例说明
没答 delivery=n.递送;交付;分娩;交货;引渡
没答 caution=n.谨慎；注意(事项)，警告 vt.劝…小心
答错 bronze=n.青铜；青铜色，古铜色；青铜制品，铜牌
答错 rod=n.杆,棒
答错 redundant=a.多余的,过剩的;(食物)丰富的;被解雇的
没答 conversely=ad.相反地
答错 expertise=n.专门知识(或技能等),专长
没答 majority=n.多数,大多数,成年,法定年龄
答错 tide=n.潮,潮汐;潮流,趋势
答错 jug=n.(有柄，小口，可盛水等的)大壶，罐，盂
没答 tariff=n.关税,税率;(旅馆,饭店等)价目表,收费表
没答 herd=n.群,兽群,牛群 v.放牧,群集
没答 ability=n.能力；本领；才能，才干；专门技能，天资
答错 trait=n.特征,特点,特性
答错 responsibility=n.责任,责任心;职责,任务
没答 nourish=v.提供养分,养育,怀有(希望,仇恨等)
答错 ribbon=n.缎带,丝带,带,带状物
答错 watt=n.瓦,瓦特
答错 journalist=n.记者,新闻工作者
没答 integrate=v.(into,with)(使)成为一体,(使)结合在一起
答错 tablet=n.药片;碑,匾
答错 conductor=n.管理者；(汽车)售票员；领队，指挥；导体 
答错 antique=a.古式的，过时的 n.有价值的古物，古董
答错 strengthen=v.加强,巩固
没答 commonplace=a.普通的，平庸的 n.寻常的事物，平庸的东西
答错 saint=n.圣人,基督教徒;(S-或 St.用于人,地名前)圣
答错 client=n.律师等的当事人，委托人；商店的顾客
答错 shrug=vt./n.耸肩(表示冷淡、怀疑、无奈、不满等)
答错 observation=n.观察,观测,监视;(pl.)观察资料;观察力
答错 affirm=vt.断言，坚持声称；肯定；证实,确认
答错 ally=n.同盟者，同盟国，vt.使结盟；与…有关联
答错 gaol=n.(jail)监狱；(不加冠词)监禁 vt.使…坐牢
答错 fringe=n.边缘；(窗帘)缘饰；额前垂发 vt.饰…的边
答错 reservoir=n.水库,蓄水池
答错 curse=n.诅咒，咒语；祸根 v.诅咒，咒骂
答错 contempt=n.轻视，藐视；受辱，丢脸
答错 atom=n.原子；微粒，微量
答错 sparkle=v.发火花,闪耀
答错 intermittent=a.间歇的,断断续续的
答错 necessity=n.必要性,需要;必然性;(pl.)必需品
答错 naked=a.裸体的,无遮敝的,无掩饰的
答错 overseas=a.外国的,海外的 ad.在海外
答错 scissors=n.剪子
答错 multiply=v.(by)乘,使相乘;倍增,增加,繁殖
答错 shear=v.剪,修剪
答错 brook=n.小溪 vt.
答错 ritual=a.宗教仪式的,典礼的 n.(宗教)仪式,典礼
答错 notify=v.通知,告知,报告
答错 atom=n.原子；微粒，微量
答错 prolong=v.拉长,延长,拖延
答错 heel=n.脚后跟,踵,鞋跟
答错 publicity=n.公开,宣传,广告,推销
答错 subjective=a.主观(上)的，个人的
答错 typical=a.(of)典型的,有代表性的
答错 swear=v.(at)诅咒,骂人;宣誓,发誓
答错 punctual=a.严守时刻的,准时的,正点的
答错 withstand=vt.抵抗,经受住
答错 enquire=v.(inquire)询问,打听;调查;查问
答错 deflector=a.反射器，偏转器
答错 indignant=a.愤慨的,愤慨不平的
答错 drip=v.滴下,漏水 n.滴,水滴,点滴
答错 minor=a.较小的,较小的 n.兼修学科 v.(in)兼修
没答 idle=a.空闲的,闲置的;懒散的 v.空费,虚度
答错 casualty=n.伤亡人员；受害人；损失的东西；急诊室
没答 conduct=n.行为,品行 v.引导;管理;指挥(乐队);传导 
答错 bewilder=v.使迷惑,难住
答错 lumber=n.木材,木料
没答 tariff=n.关税,税率;(旅馆,饭店等)价目表,收费表
答错 weird=a.古怪的，离奇的；怪诞的，神秘而可怕的
答错 differentiate=v.区分,区别;(使)不同
答错 nominal=a.名义上的;(金额,租金)微不足道的
答错 originate=v.(in,from)起源,发生;首创,创造
答错 typical=a.(of)典型的,有代表性的
答错 null
答错 null
答错 null
答错 preference=n.(for,to)偏爱,喜爱;优惠;优先选择
答错 squirrel=n.松鼠
没答 puppet=n.木偶,傀儡
没答 correspondent=n.记者,通讯员;通信者
答错 undesirable=a.不受欢迎的令人不快的
答错 notify=v.通知,告知,报告
答错 diversion=n.转向,转移;牵制;解闷;娱乐
答错 monument=n.纪念碑,纪念馆,遗迹,不朽的业绩
答错 acquire=v.获得；学到(知识等)；养成(习惯)
答错 magnificent=a.华丽的,高尚的,宏伟的
答错 banner=n.旗(帜)
答错 diagram=n.图表;图解
答错 sympathize=v.(sympathise)(with)同情;共鸣,同感;赞成
答错 scissors=n.剪子
答错 kingdom=n.王国,领域
答错 gaze=v./n.凝视,注视
答错 shipment=n.装船,装运;装载的货物,装货量
答错 category=n.种类，部属，类目；范畴，类型
没答 imitation=n.模仿,仿效;仿制;仿造品
没答 heading=n.标题
答错 chef=n.(餐馆等的)厨师长，厨师 
答错 grope=n./v.摸索,探索
答错 comprise=vt.包含，包括，由...组成；构成，组成
答错 implicit=a.含蓄的;(in)固有的;无疑问的;绝对的
答错 architecture=n.建筑，建筑学；建筑式样或风格，建筑物
答错 hence=ad.从此,今后;因此
答错 juvenile=n.青少年,少年读物 a.青少年的, 幼稚的
答错 procession=n.队伍,行列
没答 cereal=n.加工而成的谷类食物；谷类植物，谷物
